1
8 7
1 2 3 4 0 5 6 
0 1 2 3 4 5 6
4 5 6 0 1 2 3
3 4 5 6 0 1 2
2 3 4 5 6 0 1
1 2 3 4 5 6 0
0 1 2 3 4 5 6
