7 8
3 1 4 0 5 2 6
0 2 5 6 1 4 3
4 6 0 3 2 5 1
5 4 1 2 3 0 6
1 3 6 5 0 4 2
6 5 2 1 4 3 0
2 0 1 6 3 5 4
0 4 3 2 1 6 5
