1
5 5
1 2 3 4 5
2 3 4 5 0
3 4 5 0 1
4 5 0 1 2
5 0 1 2 3
